1111111111
1        1
1        1
1        1
1        1
1  1 111 1
1  1  41 1
2 222111 1
3        1
2232211111