2222222222
2        2
2 222 22 2
2 2    2 2
2        2
2 2    2 2
2 2    2 2
2 222 22 2
2        2
2222222222